S.N.,Candidate,Party,EVM Votes,Postal Votes,Total Votes,% of Votes,Constituency Name,State,Serial No.
1,BHARTI PARDHI,Bharatiya Janata Party,709939,2721,712660,51.56,BALAGHAT,Madhya Pradesh,1
2,SAMRAT ASHOK SINGH SARASWAR,Indian National Congress,536333,1815,538148,38.93,BALAGHAT,Madhya Pradesh,2
3,KANKAR MUNJARE,Bahujan Samaj Party,52883,251,53134,3.84,BALAGHAT,Madhya Pradesh,3
4,BHUVAN SINGH KORAM,Independent,13028,46,13074,0.95,BALAGHAT,Madhya Pradesh,4
5,NANDLAL UIKEY,Gondvana Gantantra Party,12338,84,12422,0.9,BALAGHAT,Madhya Pradesh,5
6,D.L. MANESHWAR,Peoples Party of India (Democratic),9994,23,10017,0.72,BALAGHAT,Madhya Pradesh,6
7,DHANENDRA DEV PAWAR BANWARI SETH,Independent,7185,60,7245,0.52,BALAGHAT,Madhya Pradesh,7
8,MAHADEV NAGDEVE,Independent,7181,11,7192,0.52,BALAGHAT,Madhya Pradesh,8
9,RAJKUMAR NAGESHWER,Independent,6723,5,6728,0.49,BALAGHAT,Madhya Pradesh,9
10,MOHAN RAUT,Rashtravadi Bharat Party,3537,5,3542,0.26,BALAGHAT,Madhya Pradesh,10
11,PRIYANKA SANJAY BHANDARKAR,Bhartiya Shakti Chetna Party,2906,20,2926,0.21,BALAGHAT,Madhya Pradesh,11
12,ADVOCATE SATYAPRAKASH SHULKE (LODHI),Madhya Pradesh Jan Vikas Party,1929,3,1932,0.14,BALAGHAT,Madhya Pradesh,12
13,DILEEP CHHABDA,Independent,1733,17,1750,0.13,BALAGHAT,Madhya Pradesh,13
14,NOTA,None of the Above,11479,31,11510,0.83,BALAGHAT,Madhya Pradesh,14
1,DURGADAS (D. D.) UIKEY,Bharatiya Janata Party,846696,1540,848236,60.76,BETUL,Madhya Pradesh,15
2,RAMU TEKAM,Indian National Congress,467810,665,468475,33.56,BETUL,Madhya Pradesh,16
3,ARJUN ASHOK BHALAVI,Bahujan Samaj Party,26559,38,26597,1.91,BETUL,Madhya Pradesh,17
4,ANIL UIKEY,Bharat Adivasi Party,10552,24,10576,0.76,BETUL,Madhya Pradesh,18
5,BHURELAL CHOTELAL BETHEKAR,Independent,7800,11,7811,0.56,BETUL,Madhya Pradesh,19
6,BHAGCHARAN WARKADE,Independent,5957,11,5968,0.43,BETUL,Madhya Pradesh,20
7,SUNER UIKEY,Gondvana Gantantra Party,4172,14,4186,0.3,BETUL,Madhya Pradesh,21
8,BARSKAR SUBHASH KORAKU,Swatantra Kisan Party,3831,18,3849,0.28,BETUL,Madhya Pradesh,22
9,NOTA,None of the Above,20309,13,20322,1.46,BETUL,Madhya Pradesh,23
1,SANDHYA RAY,Bharatiya Janata Party,533462,3603,537065,51.2,BHIND,Madhya Pradesh,24
2,PHOOL SINGH BARAIYA,Indian National Congress,470169,2056,472225,45.02,BHIND,Madhya Pradesh,25
3,DEVASHISH JARARIYA,Bahujan Samaj Party,20322,143,20465,1.95,BHIND,Madhya Pradesh,26
4,UMESH GARG,Independent,5057,15,5072,0.48,BHIND,Madhya Pradesh,27
5,REKHA SHAKYA,Independent,2645,22,2667,0.25,BHIND,Madhya Pradesh,28
6,HARIMOHAN,Independent,2598,12,2610,0.25,BHIND,Madhya Pradesh,29
7,RAKESH,Independent,2345,24,2369,0.23,BHIND,Madhya Pradesh,30
8,NOTA,None of the Above,6486,48,6534,0.62,BHIND,Madhya Pradesh,31
1,ALOK SHARMA,Bharatiya Janata Party,978285,2824,981109,65.48,BHOPAL,Madhya Pradesh,32
2,ADVOCATE ARUN SHRIVASTAVA,Indian National Congress,478698,912,479610,32.01,BHOPAL,Madhya Pradesh,33
3,BHANU PRATAP SINGH,Bahujan Samaj Party,13255,50,13305,0.89,BHOPAL,Madhya Pradesh,34
4,DEENDAYAL AHIRWAR URF DEENU BHAIYA,Independent,3639,2,3641,0.24,BHOPAL,Madhya Pradesh,35
5,JAY SINGH,Independent,2509,1,2510,0.17,BHOPAL,Madhya Pradesh,36
6,BHARTI YADAV,Independent,1833,6,1839,0.12,BHOPAL,Madhya Pradesh,37
7,ANKIT RAI,Independent,1100,1,1101,0.07,BHOPAL,Madhya Pradesh,38
8,DHANRAJ SHENDE,Republican Party of India (A),788,2,790,0.05,BHOPAL,Madhya Pradesh,39
9,AJAY KUMAR PATHAK,Chhatrapati Shivaji Bhartiya Garib Party,787,3,790,0.05,BHOPAL,Madhya Pradesh,40
10,MOHAMMAD ASHRAF,Independent,777,1,778,0.05,BHOPAL,Madhya Pradesh,41
11,BABULAL SEN,Moulik Adhikar Party,718,2,720,0.05,BHOPAL,Madhya Pradesh,42
12,SANJAY KUMAR SAROJ,Manav Samadhan Party,621,1,622,0.04,BHOPAL,Madhya Pradesh,43
13,BALRAM SINGH TAUMAR,Bhartiya Shakti Chetna Party,587,1,588,0.04,BHOPAL,Madhya Pradesh,44
14,RAMPRASAD PATEL,Kranti Janshakti Party,572,3,575,0.04,BHOPAL,Madhya Pradesh,45
15,MUDIT CHAURASIA,Akhil Bhartiya Aarakshit Samaj Party,541,3,544,0.04,BHOPAL,Madhya Pradesh,46
16,MUDIT BHATNAGAR,Socialist Unity Centre Of India (COMMUNIST),537,3,540,0.04,BHOPAL,Madhya Pradesh,47
17,R.K. MAHAJAN,Independent,527,2,529,0.04,BHOPAL,Madhya Pradesh,48
18,ABDUL TAHIR ADVOCATE (BABLU RAJNIKANT)  S/O SAEED PAHELWAN ANSARI,Bahujan Maha Party,473,-,473,0.03,BHOPAL,Madhya Pradesh,49
19,MAITHILI SHARAN GUPTA,Independent,447,1,448,0.03,BHOPAL,Madhya Pradesh,50
20,RAJESH KEER,Independent,427,-,427,0.03,BHOPAL,Madhya Pradesh,51
21,AKSHAY GOTHI,Parivartan Party of India,403,4,407,0.03,BHOPAL,Madhya Pradesh,52
22,HITENDRA SHAHARE (BABA),Independent,318,-,318,0.02,BHOPAL,Madhya Pradesh,53
23,NOTA,None of the Above,6573,48,6621,0.44,BHOPAL,Madhya Pradesh,54
1,BUNTY VIVEK SAHU,Bharatiya Janata Party,643489,1249,644738,49.41,CHHINDWARA,Madhya Pradesh,55
2,NAKUL KAMALNATH,Indian National Congress,529931,1189,531120,40.7,CHHINDWARA,Madhya Pradesh,56
3,DEVIRAM URF DEV RAVEN BHALAVI,Gondvana Gantantra Party,55854,134,55988,4.29,CHHINDWARA,Madhya Pradesh,57
4,UMAKANT BANDEWAR,Bahujan Samaj Party,11802,21,11823,0.91,CHHINDWARA,Madhya Pradesh,58
5,KAPIL SONI,Rashtriya Gondvana Party,9634,4,9638,0.74,CHHINDWARA,Madhya Pradesh,59
6,SIRAJ SHEKH,Independent,9567,1,9568,0.73,CHHINDWARA,Madhya Pradesh,60
7,PAWANSHAH SARYAM,Independent,6612,9,6621,0.51,CHHINDWARA,Madhya Pradesh,61
8,SUBHASH SHUKLA,Independent,5768,1,5769,0.44,CHHINDWARA,Madhya Pradesh,62
9,RAJENDRA DONGRE,Independent,4628,4,4632,0.35,CHHINDWARA,Madhya Pradesh,63
10,GOVIND BHALAVI,Independent,4022,7,4029,0.31,CHHINDWARA,Madhya Pradesh,64
11,MOHD. PARVEZ QURESHI,Independent,3818,10,3828,0.29,CHHINDWARA,Madhya Pradesh,65
12,AJAY BARKADE,Independent,2491,4,2495,0.19,CHHINDWARA,Madhya Pradesh,66
13,KUSHWAHA RAJESH TANTRIK,Ahinsa Samaj Party,1695,3,1698,0.13,CHHINDWARA,Madhya Pradesh,67
14,""" PRAKASH ALIAS BANTY "" PARTETI",Rashtra Samarpan Party,1652,2,1654,0.13,CHHINDWARA,Madhya Pradesh,68
15,FOGAL BANSOD,Republican Party of India (A),1322,1,1323,0.1,CHHINDWARA,Madhya Pradesh,69
16,NOTA,None of the Above,9887,16,9903,0.76,CHHINDWARA,Madhya Pradesh,70
1,RAHUL SINGH LODHI,Bharatiya Janata Party,708589,1179,709768,65.18,DAMOH,Madhya Pradesh,71
2,TARBAR SINGH LODHI (BANTU BHAIYA),Indian National Congress,302828,514,303342,27.86,DAMOH,Madhya Pradesh,72
3,ENGINEER GOVERDHAN RAJ,Bahujan Samaj Party,21379,25,21404,1.97,DAMOH,Madhya Pradesh,73
4,BHAIYA VIJAY PATEL (KURMI) TIRGARH BALE,Bhartiya Shakti Chetna Party,12200,17,12217,1.12,DAMOH,Madhya Pradesh,74
5,MANU SINGH MARAVI,Bharat Adivasi Party,7871,16,7887,0.72,DAMOH,Madhya Pradesh,75
6,RAHUL BHAIYA S/O RAM PRATAP,Independent,6273,12,6285,0.58,DAMOH,Madhya Pradesh,76
7,RAHUL BHAIYA S/O JEEVAN LAL,Independent,5556,5,5561,0.51,DAMOH,Madhya Pradesh,77
8,VEDRAM KURMI,Independent,4054,3,4057,0.37,DAMOH,Madhya Pradesh,78
9,RAJESH SINGH SOYAM,Gondvana Gantantra Party,3172,18,3190,0.29,DAMOH,Madhya Pradesh,79
10,RAKESH KUMAR AHIRWAR,Independent,2044,7,2051,0.19,DAMOH,Madhya Pradesh,80
11,NANDAN KUMAR AHIRWAL,Independent,1848,5,1853,0.17,DAMOH,Madhya Pradesh,81
12,NEELESH SONI,Independent,1277,1,1278,0.12,DAMOH,Madhya Pradesh,82
13,DURGA MOUSI,Independent,1120,4,1124,0.1,DAMOH,Madhya Pradesh,83
14,TARVAR SINGH LODHI,Independent,1092,2,1094,0.1,DAMOH,Madhya Pradesh,84
15,NOTA,None of the Above,7820,13,7833,0.72,DAMOH,Madhya Pradesh,85
1,MAHENDRA SINGH SOLANKY,Bharatiya Janata Party,925917,3024,928941,63.23,DEWAS,Madhya Pradesh,86
2,RAJENDRA RADHAKISHAN MALVIYA,Indian National Congress,502548,1168,503716,34.29,DEWAS,Madhya Pradesh,87
3,RAJENDRASINGH CHOKHUTIYA,Bahujan Samaj Party,11162,41,11203,0.76,DEWAS,Madhya Pradesh,88
4,RAMPRASAD,Aazad Samaj Party (Kanshi Ram),7201,19,7220,0.49,DEWAS,Madhya Pradesh,89
5,NITIN VERMA,Independent,2756,5,2761,0.19,DEWAS,Madhya Pradesh,90
6,ADVOCATE VIDAYARAJ MALAVIY,Social Democratic Party Of India,2026,5,2031,0.14,DEWAS,Madhya Pradesh,91
7,ENG. DEEPAK RAMESH CHANDRA VICHITRA,Independent,1585,10,1595,0.11,DEWAS,Madhya Pradesh,92
8,HEMRAJ POONAMCHANDRA BAMNIYA,Public Political Party,1236,12,1248,0.08,DEWAS,Madhya Pradesh,93
9,NOTA,None of the Above,10365,24,10389,0.71,DEWAS,Madhya Pradesh,94
1,SAVITRI THAKUR,Bharatiya Janata Party,792591,1858,794449,55.75,DHAR,Madhya Pradesh,95
2,RADHESHYAM MUVEL,Indian National Congress,574756,1028,575784,40.4,DHAR,Madhya Pradesh,96
3,DHUMSINGH MANDLOI MACHHAR,Bahujan Samaj Party,14926,30,14956,1.05,DHAR,Madhya Pradesh,97
4,JITENDRA MUNIYA,Bharat Adivasi Party,10586,35,10621,0.75,DHAR,Madhya Pradesh,98
5,SUNIL AJRAWAT,Independent,5400,8,5408,0.38,DHAR,Madhya Pradesh,99
6,SHIVAJI PATEL KALMI,Independent,4694,6,4700,0.33,DHAR,Madhya Pradesh,100
7,VIKRAM VASUNIYA,Janata Congress,3464,11,3475,0.24,DHAR,Madhya Pradesh,101
8,NOTA,None of the Above,15612,39,15651,1.1,DHAR,Madhya Pradesh,102
1,JYOTIRADITYA M. SCINDIA,Bharatiya Janata Party,919744,3558,923302,67.21,GUNA,Madhya Pradesh,103
2,YADVENDRA RAO DESHRAJ SINGH,Indian National Congress,380909,1464,382373,27.83,GUNA,Madhya Pradesh,104
3,DHANIRAM CHAUDHARY,Bahujan Samaj Party,30105,130,30235,2.2,GUNA,Madhya Pradesh,105
4,KANCHHEDI LAL KUSHWAHA,Mahanwadi Party,5850,6,5856,0.43,GUNA,Madhya Pradesh,106
5,ADVOCATE KARANSINGH JATAV,Aazad Samaj Party (Kanshi Ram),5474,11,5485,0.4,GUNA,Madhya Pradesh,107
6,HEMANT SINGH KUSHWAHA,Independent,3450,3,3453,0.25,GUNA,Madhya Pradesh,108
7,RAKESH,Independent,3051,1,3052,0.22,GUNA,Madhya Pradesh,109
8,MAHENDRA JAIN BHAIYAN,Independent,1990,9,1999,0.15,GUNA,Madhya Pradesh,110
9,MOHAN,Independent,1883,3,1886,0.14,GUNA,Madhya Pradesh,111
10,GAJANAND KUSHWAH,Independent,1595,2,1597,0.12,GUNA,Madhya Pradesh,112
11,MANISH SHRIVASTAVA,Socialist Unity Centre Of India (COMMUNIST),1342,6,1348,0.1,GUNA,Madhya Pradesh,113
12,MANMOHAN,Independent,1143,6,1149,0.08,GUNA,Madhya Pradesh,114
13,KISAN LAL AHIRWAR,Independent,1033,11,1044,0.08,GUNA,Madhya Pradesh,115
14,MOHAMMAD JAVED ANSARI,Rashtriya Jansena Party,983,-,983,0.07,GUNA,Madhya Pradesh,116
15,D.S. CHAUHAN (ADVOCATE),Rashtriya Samaj Paksha,913,2,915,0.07,GUNA,Madhya Pradesh,117
16,NOTA,None of the Above,9055,34,9089,0.66,GUNA,Madhya Pradesh,118
1,BHARAT SINGH KUSHWAH,Bharatiya Janata Party,668782,2753,671535,49.99,GWALIOR,Madhya Pradesh,119
2,PRAVEEN PATHAK,Indian National Congress,599077,2248,601325,44.77,GWALIOR,Madhya Pradesh,120
3,KALYAN SINGH KANSANA,Bahujan Samaj Party,33308,157,33465,2.49,GWALIOR,Madhya Pradesh,121
4,ARCHANA SINGH RATHORE,Rashtriya Samaj Paksha,5873,19,5892,0.44,GWALIOR,Madhya Pradesh,122
5,BHARAT PAL,Aazad Samaj Party (Kanshi Ram),4138,25,4163,0.31,GWALIOR,Madhya Pradesh,123
6,ER. MAHENDRA PRATAP SINGH PAL,Independent,3777,6,3783,0.28,GWALIOR,Madhya Pradesh,124
7,RAKESH DHAKAD,Independent,3218,2,3220,0.24,GWALIOR,Madhya Pradesh,125
8,YASHDEV SHARMA,Independent,2568,3,2571,0.19,GWALIOR,Madhya Pradesh,126
9,DEEPAK KUMAR BANSAL (RANG WALE),Independent,2448,-,2448,0.18,GWALIOR,Madhya Pradesh,127
10,SHREE NARESH CHANDRA SHARMA,Independent,2215,1,2216,0.16,GWALIOR,Madhya Pradesh,128
11,GAJENDRA SINGH,Independent,1343,5,1348,0.1,GWALIOR,Madhya Pradesh,129
12,ANJALI MONU RAWAT,Parivartan Party of India,1272,7,1279,0.1,GWALIOR,Madhya Pradesh,130
13,ADVOCATE MUKESH KUMAR KORI,Independent,1130,4,1134,0.08,GWALIOR,Madhya Pradesh,131
14,RAM PRAKASH SINGH PAL,Rashtra Uday Party,1059,12,1071,0.08,GWALIOR,Madhya Pradesh,132
15,CHANDAN RATHORE,Parivartan Samaj Party,1053,6,1059,0.08,GWALIOR,Madhya Pradesh,133
16,DR. P. D. AGARWAL SR. MEDICAL CONSULTANT,Independent,1016,5,1021,0.08,GWALIOR,Madhya Pradesh,134
17,AMIT PARIHAR,Independent,877,6,883,0.07,GWALIOR,Madhya Pradesh,135
18,COMRADE RACHNA AGRAWAL,Socialist Unity Centre Of India (COMMUNIST),798,5,803,0.06,GWALIOR,Madhya Pradesh,136
19,MUNESH NAGAR,Vikas India Party,667,5,672,0.05,GWALIOR,Madhya Pradesh,137
20,NOTA,None of the Above,3309,32,3341,0.25,GWALIOR,Madhya Pradesh,138
1,DARSHAN SINGH CHOUDHARY,Bharatiya Janata Party,810529,1618,812147,64.99,HOSHANGABAD,Madhya Pradesh,139
2,SANJAY SHARMA SANJU BHAIYA,Indian National Congress,379868,583,380451,30.44,HOSHANGABAD,Madhya Pradesh,140
3,RAMGOVIND BARUAA,Bahujan Samaj Party,15344,43,15387,1.23,HOSHANGABAD,Madhya Pradesh,141
4,PANDIT DIVYENDRA BRIJMOHAN DUBEY ADVOCATE,Bharatiya Yuva Jan Ekta Party,6157,11,6168,0.49,HOSHANGABAD,Madhya Pradesh,142
5,RAKESH RAMPRASAD RICKY,Independent,5071,8,5079,0.41,HOSHANGABAD,Madhya Pradesh,143
6,SARJERAO SAHARE,Independent,4487,6,4493,0.36,HOSHANGABAD,Madhya Pradesh,144
7,PATRAKAR TILAK JATAV,Independent,2257,3,2260,0.18,HOSHANGABAD,Madhya Pradesh,145
8,YUVRAJ GAVADE,Independent,2205,10,2215,0.18,HOSHANGABAD,Madhya Pradesh,146
9,JYOTI SURESH JHARIYA,Independent,2033,13,2046,0.16,HOSHANGABAD,Madhya Pradesh,147
10,MAKHAN SINGH LODHI,Bhartiya Shakti Chetna Party,1651,6,1657,0.13,HOSHANGABAD,Madhya Pradesh,148
11,MUKESH YADAV,Independent,1578,10,1588,0.13,HOSHANGABAD,Madhya Pradesh,149
12,PANDIT BRAJESH KHEMARIYA,Independent,1251,9,1260,0.1,HOSHANGABAD,Madhya Pradesh,150
13,NOTA,None of the Above,14927,14,14941,1.2,HOSHANGABAD,Madhya Pradesh,151
1,SHANKAR LALWANI,Bharatiya Janata Party,1223746,3005,1226751,78.54,INDORE,Madhya Pradesh,152
2,SANJAY S/O LAKSHMAN SOLANKI,Bahujan Samaj Party,51486,173,51659,3.31,INDORE,Madhya Pradesh,153
3,PAWAN KUMAR,Akhil Bhartiya Parivar Party,15182,28,15210,0.97,INDORE,Madhya Pradesh,154
4,ABHAY JAIN,Independent,8379,13,8392,0.54,INDORE,Madhya Pradesh,155
5,LAVISH DILIP KHANDELWAL,Independent,8231,7,8238,0.53,INDORE,Madhya Pradesh,156
6,COMRADE AJEET SINGH,Socialist Unity Centre Of India (COMMUNIST),7148,31,7179,0.46,INDORE,Madhya Pradesh,157
7,AYAZ ALI,Independent,7074,22,7096,0.45,INDORE,Madhya Pradesh,158
8,ENG. ARJUN PARIHAR,Independent,3823,8,3831,0.25,INDORE,Madhya Pradesh,159
9,BASANT GEHLOT,Jan Sangh Party,3663,13,3676,0.24,INDORE,Madhya Pradesh,160
10,RAVI SIRWAIYA,Independent,2615,6,2621,0.17,INDORE,Madhya Pradesh,161
11,MUDIT CHAURASIA,Independent,2601,8,2609,0.17,INDORE,Madhya Pradesh,162
12,PARMANAND TOLANI,Independent,2399,4,2403,0.15,INDORE,Madhya Pradesh,163
13,DESH BHAKT ANKIT GUPTA,Independent,1957,12,1969,0.13,INDORE,Madhya Pradesh,164
14,ADVOCATE PANKAJ GUPTE,Independent,1652,8,1660,0.11,INDORE,Madhya Pradesh,165
15,NOTA,None of the Above,218355,319,218674,14,INDORE,Madhya Pradesh,166
1,ASHISH DUBEY,Bharatiya Janata Party,788721,1412,790133,68.2,JABALPUR,Madhya Pradesh,167
2,DINESH YADAV,Indian National Congress,302892,567,303459,26.19,JABALPUR,Madhya Pradesh,168
3,RAKESH CHOUDHARY,Bahujan Samaj Party,21389,27,21416,1.85,JABALPUR,Madhya Pradesh,169
4,FOJI VIJAY HALDKAR (EX-ARMY),Independent,7028,15,7043,0.61,JABALPUR,Madhya Pradesh,170
5,MAHAVEER JAIN,Independent,6463,5,6468,0.56,JABALPUR,Madhya Pradesh,171
6,ADVOCATE UDAY KUMAR SAHU,Gondvana Gantantra Party,4832,16,4848,0.42,JABALPUR,Madhya Pradesh,172
7,"ER. PRAVIN GAJBHIYE ""DADA""",Independent,3437,3,3440,0.3,JABALPUR,Madhya Pradesh,173
8,POORNESH KUMAR JAIN,Independent,2822,1,2823,0.24,JABALPUR,Madhya Pradesh,174
9,SWATANATRA SAMAJ SEVI VINAY CHAKRAVARTI,Independent,2488,3,2491,0.22,JABALPUR,Madhya Pradesh,175
10,JAGDISH SINGH LODHI,Bhartiya Shakti Chetna Party,1871,4,1875,0.16,JABALPUR,Madhya Pradesh,176
11,DINESH YADAV,Independent,1480,4,1484,0.13,JABALPUR,Madhya Pradesh,177
12,DR. DHAI AKSHAR,Independent,1399,1,1400,0.12,JABALPUR,Madhya Pradesh,178
13,ASHOK RANA,Rashtra Nirman Party,1226,2,1228,0.11,JABALPUR,Madhya Pradesh,179
14,SANTOSH KUMAR KUSHWAHA,Independent,1202,2,1204,0.1,JABALPUR,Madhya Pradesh,180
15,DASAI RAM KOL,Aadim Samaj Party,1099,1,1100,0.09,JABALPUR,Madhya Pradesh,181
16,COMRADE SACHIN JAIN,Socialist Unity Centre Of India (COMMUNIST),868,8,876,0.08,JABALPUR,Madhya Pradesh,182
17,GULAB SINGH,Independent,821,8,829,0.07,JABALPUR,Madhya Pradesh,183
18,LAL SINGH,Rashtriya Samaj Dal (R),748,4,752,0.06,JABALPUR,Madhya Pradesh,184
19,RAMKUMAR PASI,Bahujan Awam Party,684,6,690,0.06,JABALPUR,Madhya Pradesh,185
20,NOTA,None of the Above,4964,22,4986,0.43,JABALPUR,Madhya Pradesh,186
1,VISHNU DATT SHARMA (V.D.SHARMA),Bharatiya Janata Party,771014,1760,772774,67.75,KHAJURAHO,Madhya Pradesh,187
2,KAMLESH KUMAR,Bahujan Samaj Party,231163,382,231545,20.3,KHAJURAHO,Madhya Pradesh,188
3,R. B. PRAJAPATI (RAJA BHAIYA) EX.I.A.S.,All India Forward Bloc,50033,182,50215,4.4,KHAJURAHO,Madhya Pradesh,189
4,MOHAMMAD IMRAN,Rashtriya Jansambhavna Party,17853,20,17873,1.57,KHAJURAHO,Madhya Pradesh,190
5,PENTER SUNMAN SINGH LODHI,Independent,10005,6,10011,0.88,KHAJURAHO,Madhya Pradesh,191
6,KAPIL GUPTA BHARTIYA,Akhil Bhartiya Parivar Party,7540,24,7564,0.66,KHAJURAHO,Madhya Pradesh,192
7,LAXMI PRASAD,Independent,6752,12,6764,0.59,KHAJURAHO,Madhya Pradesh,193
8,NANDKISHOR,Peoples Party of India (Democratic),6019,8,6027,0.53,KHAJURAHO,Madhya Pradesh,194
9,PANKAJ MAURYA (KUSHWAHA),Gondvana Gantantra Party,4730,10,4740,0.42,KHAJURAHO,Madhya Pradesh,195
10,BITIAYA AHIRWAR,Independent,4018,8,4026,0.35,KHAJURAHO,Madhya Pradesh,196
11,FIROJKHAN,Independent,3708,5,3713,0.33,KHAJURAHO,Madhya Pradesh,197
12,GIRAN SINGH,Bhartiya Shakti Chetna Party,3485,7,3492,0.31,KHAJURAHO,Madhya Pradesh,198
13,KESHKALI,Rashtriya Jansanchar Dal,2861,11,2872,0.25,KHAJURAHO,Madhya Pradesh,199
14,PANNA LAL TRIPATHI AD.,Indian Peoples Adhikar Party,2794,3,2797,0.25,KHAJURAHO,Madhya Pradesh,200
15,NOTA,None of the Above,16134,23,16157,1.42,KHAJURAHO,Madhya Pradesh,201
1,GYANESHWAR PATIL,Bharatiya Janata Party,861188,1491,862679,57.04,KHANDWA,Madhya Pradesh,202
2,NARENDRA PATEL,Indian National Congress,591540,1168,592708,39.19,KHANDWA,Madhya Pradesh,203
3,MUNNALAL S/O DHANNALAL TEJI,Bahujan Samaj Party,11796,22,11818,0.78,KHANDWA,Madhya Pradesh,204
4,ABHINESH SINGH,Rashtriya Jan Awaz Party,9295,4,9299,0.61,KHANDWA,Madhya Pradesh,205
5,LAXMI NARAYAN KATARE,Independent,4902,3,4905,0.32,KHANDWA,Madhya Pradesh,206
6,MANOJ KUMAR VISHWAMBHARNATH AGRAWAL,Independent,4346,1,4347,0.29,KHANDWA,Madhya Pradesh,207
7,MAHESH PAWAR,Peoples Party of India (Democratic),3701,8,3709,0.25,KHANDWA,Madhya Pradesh,208
8,SHIVAM SEN,Independent,3479,2,3481,0.23,KHANDWA,Madhya Pradesh,209
9,RAVINDRA SONVANE,Independent,2679,6,2685,0.18,KHANDWA,Madhya Pradesh,210
10,PRAKASH RATHOR BANJARA,Aam Janta Party (India),2368,2,2370,0.16,KHANDWA,Madhya Pradesh,211
11,NARAYAN SUKHADEV PAL,Bharatiya Yuva Jan Ekta Party,1699,3,1702,0.11,KHANDWA,Madhya Pradesh,212
12,NOTA,None of the Above,12817,22,12839,0.85,KHANDWA,Madhya Pradesh,213
1,GAJENDRA SINGH PATEL,Bharatiya Janata Party,818291,1572,819863,52.6,KHARGONE,Madhya Pradesh,214
2,PORLAL BATHA KHARTE,Indian National Congress,683651,1194,684845,43.93,KHARGONE,Madhya Pradesh,215
3,DEVISINGH NARGAVE,Communist Party of India,14680,6,14686,0.94,KHARGONE,Madhya Pradesh,216
4,SHOBHARAM DAWAR,Bahujan Samaj Party,12047,22,12069,0.77,KHARGONE,Madhya Pradesh,217
5,NARSINGH SOLANKI,Independent,9052,6,9058,0.58,KHARGONE,Madhya Pradesh,218
6,NOTA,None of the Above,18237,20,18257,1.17,KHARGONE,Madhya Pradesh,219
1,FAGGAN SINGH KULASTE,Bharatiya Janata Party,749761,1614,751375,48.93,MANDLA,Madhya Pradesh,220
2,OMKAR SINGH MARKAM,Indian National Congress,645759,1770,647529,42.17,MANDLA,Madhya Pradesh,221
3,MAHESH KUMAR WATTEE,Gondvana Gantantra Party,37686,111,37797,2.46,MANDLA,Madhya Pradesh,222
4,INDAR SINGH UIKEY,Bahujan Samaj Party,16587,30,16617,1.08,MANDLA,Madhya Pradesh,223
5,CHANDRA SINGH KUSHRAM,Bhartiya Shakti Chetna Party,15533,25,15558,1.01,MANDLA,Madhya Pradesh,224
6,SITAR MARKAM,Independent,10365,10,10375,0.68,MANDLA,Madhya Pradesh,225
7,RAKESH SINGH THAKUR,Independent,10340,6,10346,0.67,MANDLA,Madhya Pradesh,226
8,DR. BHAW SINGH TEKAM,Independent,6393,8,6401,0.42,MANDLA,Madhya Pradesh,227
9,CHARAN SINGH DHURWEY,Bharat Adivasi Party,4269,18,4287,0.28,MANDLA,Madhya Pradesh,228
10,ADVOCATE-DEV SINGH KUMRE,Independent,4205,12,4217,0.27,MANDLA,Madhya Pradesh,229
11,GHUR SINGH SALLAM,Independent,3959,12,3971,0.26,MANDLA,Madhya Pradesh,230
12,KALIYA BAI KAKODIA,Independent,2990,11,3001,0.2,MANDLA,Madhya Pradesh,231
13,ASHOK SARAIYA,Independent,2717,10,2727,0.18,MANDLA,Madhya Pradesh,232
14,RAMKUMAR INWATI [ADVOCATE],Smart Indians Party,2499,11,2510,0.16,MANDLA,Madhya Pradesh,233
15,NOTA,None of the Above,18887,34,18921,1.23,MANDLA,Madhya Pradesh,234
1,SUDHEER GUPTA,Bharatiya Janata Party,942249,3512,945761,65.98,MANDSOUR,Madhya Pradesh,235
2,DILIP SINGH GURJAR,Indian National Congress,443622,1484,445106,31.05,MANDSOUR,Madhya Pradesh,236
3,KANHAIYALAL MALVIYA,Bahujan Samaj Party,10456,56,10512,0.73,MANDSOUR,Madhya Pradesh,237
4,ISMAIL KHAN MAIV,Independent,8810,16,8826,0.62,MANDSOUR,Madhya Pradesh,238
5,SUSHIL,Independent,3432,7,3439,0.24,MANDSOUR,Madhya Pradesh,239
6,SAEED AHAMAD,Independent,3165,2,3167,0.22,MANDSOUR,Madhya Pradesh,240
7,MURALIDHAR,Independent,2682,14,2696,0.19,MANDSOUR,Madhya Pradesh,241
8,VIJAY RANN,Independent,2314,9,2323,0.16,MANDSOUR,Madhya Pradesh,242
9,NOTA,None of the Above,11615,47,11662,0.81,MANDSOUR,Madhya Pradesh,243
1,SHIVMANGAL SINGH TOMAR,Bharatiya Janata Party,513136,2341,515477,43.41,MORENA,Madhya Pradesh,244
2,NEETU SATYAPAL SINGH SIKARWAR,Indian National Congress,461808,1139,462947,38.99,MORENA,Madhya Pradesh,245
3,RAMESH GARG,Bahujan Samaj Party,179492,177,179669,15.13,MORENA,Madhya Pradesh,246
4,NEERAJ CHANDSORIYA,Aazad Samaj Party (Kanshi Ram),7534,10,7544,0.64,MORENA,Madhya Pradesh,247
5,RAJENDRA PRASAD KUSHWAH,Independent,2392,10,2402,0.2,MORENA,Madhya Pradesh,248
6,ER. SURAJ KUSHWAH,Independent,2279,6,2285,0.19,MORENA,Madhya Pradesh,249
7,RAMNIWASH,Independent,1970,3,1973,0.17,MORENA,Madhya Pradesh,250
8,RAM SUNDER SHARMA,Independent,1762,5,1767,0.15,MORENA,Madhya Pradesh,251
9,RAMSEVAK SAKHWAR,Independent,1630,2,1632,0.14,MORENA,Madhya Pradesh,252
10,HARIKANTH,Independent,1623,-,1623,0.14,MORENA,Madhya Pradesh,253
11,RAJKUMARI,Independent,1435,6,1441,0.12,MORENA,Madhya Pradesh,254
12,ANOOP NAGAR,Independent,1308,9,1317,0.11,MORENA,Madhya Pradesh,255
13,RAJENDRA SINGH GURJER,Independent,1199,11,1210,0.1,MORENA,Madhya Pradesh,256
14,PIYUSH BRAJESH RAJORIYA,Independent,572,3,575,0.05,MORENA,Madhya Pradesh,257
15,PRABHU JATAV,Independent,547,8,555,0.05,MORENA,Madhya Pradesh,258
16,NOTA,None of the Above,4899,15,4914,0.41,MORENA,Madhya Pradesh,259
1,RODMAL NAGAR,Bharatiya Janata Party,756139,2604,758743,53.1,RAJGARH,Madhya Pradesh,260
2,DIGVIJAYA SINGH,Indian National Congress,610602,2052,612654,42.87,RAJGARH,Madhya Pradesh,261
3,DR. RAJENDRA SURYAVANSHI,Bahujan Samaj Party,13902,40,13942,0.98,RAJGARH,Madhya Pradesh,262
4,ASHOK PAWAR,Samata Samadhan Party,6597,17,6614,0.46,RAJGARH,Madhya Pradesh,263
5,JITENDRA SINGH,National World Leader Party,5051,12,5063,0.35,RAJGARH,Madhya Pradesh,264
6,DINESH RAZAWAT,Aazad Samaj Party (Kanshi Ram),4170,9,4179,0.29,RAJGARH,Madhya Pradesh,265
7,RODMAL,Independent,3733,11,3744,0.26,RAJGARH,Madhya Pradesh,266
8,ANIL JAIN,Independent,3069,20,3089,0.22,RAJGARH,Madhya Pradesh,267
9,RADHESHYAM MALVIYA,Independent,2796,3,2799,0.2,RAJGARH,Madhya Pradesh,268
10,SUNEEL BHEEL,Independent,2703,10,2713,0.19,RAJGARH,Madhya Pradesh,269
11,VISHAL SONI (ADVOCATE),Bharatiya Yuva Jan Ekta Party,2544,16,2560,0.18,RAJGARH,Madhya Pradesh,270
12,JAGDISH KARPENTER,Independent,1730,4,1734,0.12,RAJGARH,Madhya Pradesh,271
13,ANIL,Independent,1414,4,1418,0.1,RAJGARH,Madhya Pradesh,272
14,RAMCHARAN PIRJAPATI,Lok Samaj Party,1292,2,1294,0.09,RAJGARH,Madhya Pradesh,273
15,BABU SINGH,Sajag Samaj Party,1186,5,1191,0.08,RAJGARH,Madhya Pradesh,274
16,NOTA,None of the Above,7248,12,7260,0.51,RAJGARH,Madhya Pradesh,275
1,ANITA NAGARSINGH CHOUHAN,Bharatiya Janata Party,793432,2431,795863,51.93,RATLAM,Madhya Pradesh,276
2,KANTILAL BHURIA,Indian National Congress,586904,1727,588631,38.41,RATLAM,Madhya Pradesh,277
3,ENGINEER BALUSINGH GAMAD,Bharat Adivasi Party,52525,234,52759,3.44,RATLAM,Madhya Pradesh,278
4,RAMCHANDRA SOLANKI,Bahujan Samaj Party,15159,13,15172,0.99,RATLAM,Madhya Pradesh,279
5,SURAJ BHABHAR,Independent,10060,2,10062,0.66,RATLAM,Madhya Pradesh,280
6,RANGLA KALESH,Independent,7331,4,7335,0.48,RATLAM,Madhya Pradesh,281
7,KASNA RANA PARGI,Independent,7311,5,7316,0.48,RATLAM,Madhya Pradesh,282
8,SUMITRA MEDA,Independent,6927,3,6930,0.45,RATLAM,Madhya Pradesh,283
9,RAMESHWAR SINGAR,Independent,4603,4,4607,0.3,RATLAM,Madhya Pradesh,284
10,MOHANSINGH NINGWAL,Bhartiya Samajik Party,4503,4,4507,0.29,RATLAM,Madhya Pradesh,285
11,SHEETAL BARELA,Akhand Bharat Samrajya Party,3929,1,3930,0.26,RATLAM,Madhya Pradesh,286
12,UDESINGH MACHAR,Republican Party of India (A),3795,1,3796,0.25,RATLAM,Madhya Pradesh,287
13,NOTA,None of the Above,31697,38,31735,2.07,RATLAM,Madhya Pradesh,288
1,JANARDAN MISHRA,Bharatiya Janata Party,475439,2020,477459,52,REWA,Madhya Pradesh,289
2,NEELAM ABHAY MISHRA,Indian National Congress,283187,898,284085,30.94,REWA,Madhya Pradesh,290
3,ADV. ABHISHEK MASTER BUDDHSEN PATEL,Bahujan Samaj Party,117089,132,117221,12.77,REWA,Madhya Pradesh,291
4,DAYASHANKAR PANDEY,Independent,4609,1,4610,0.5,REWA,Madhya Pradesh,292
5,ROSHAN LAL KOL,Independent,4110,12,4122,0.45,REWA,Madhya Pradesh,293
6,ER. DEVENDRA SINGH,Sapaks Party,4065,11,4076,0.44,REWA,Madhya Pradesh,294
7,ER. RAM KUMAR SONI,Independent,3868,5,3873,0.42,REWA,Madhya Pradesh,295
8,RAM GOPAL SINGH,Peoples Party of India (Democratic),3502,7,3509,0.38,REWA,Madhya Pradesh,296
9,PRASSAN JEET SINGH,Independent,3306,7,3313,0.36,REWA,Madhya Pradesh,297
10,JANARDAN MISHRA,Independent,2274,21,2295,0.25,REWA,Madhya Pradesh,298
11,RANJAN GUPTA,Rashtravadi Bharat Party,2151,9,2160,0.24,REWA,Madhya Pradesh,299
12,VIPIN SINGH PATEL,Rashtriya Hind Ekta Dal,1799,7,1806,0.2,REWA,Madhya Pradesh,300
13,ARUNENDRA NARAYAN PANDEY,Independent,1550,1,1551,0.17,REWA,Madhya Pradesh,301
14,ARUN TIWARI 'MINTU',Independent,1113,-,1113,0.12,REWA,Madhya Pradesh,302
15,NOTA,None of the Above,6916,20,6936,0.76,REWA,Madhya Pradesh,303
1,DR. LATA WANKHEDE,Bharatiya Janata Party,786160,1819,787979,68.49,SAGAR,Madhya Pradesh,304
2,CHANDRA BHUSAN SINGH BUNDELA 'GUDDU RAJA',Indian National Congress,316059,698,316757,27.53,SAGAR,Madhya Pradesh,305
3,BHAGWATI PRASAD JATAV,Bahujan Samaj Party,16592,44,16636,1.45,SAGAR,Madhya Pradesh,306
4,BHEEKAM SINGH KUSHWAHA,Mahanwadi Party,5778,6,5784,0.5,SAGAR,Madhya Pradesh,307
5,RAM BHJAN BANSAL,Samata Party,3149,4,3153,0.27,SAGAR,Madhya Pradesh,308
6,MOHAMAD AARIF MAKRANI,Independent,2888,-,2888,0.25,SAGAR,Madhya Pradesh,309
7,SANGRAM SINGH YADAV,Independent,2819,5,2824,0.25,SAGAR,Madhya Pradesh,310
8,DHARMENDRA BANPURIYA,Independent,1621,3,1624,0.14,SAGAR,Madhya Pradesh,311
9,TOSHMANI PANTHI (KANNA),Independent,1293,6,1299,0.11,SAGAR,Madhya Pradesh,312
10,SURESH BANSAL,Bhartiya Shakti Chetna Party,1147,4,1151,0.1,SAGAR,Madhya Pradesh,313
11,LAXMI KUSHWAHA,Pichhara Samaj Party United,947,5,952,0.08,SAGAR,Madhya Pradesh,314
12,DR. RAMAVATAR SHARMA,Socialist Unity Centre Of India (COMMUNIST),924,4,928,0.08,SAGAR,Madhya Pradesh,315
13,AHIRWAR RAJKUMAR THEKEDAAR,Independent,914,3,917,0.08,SAGAR,Madhya Pradesh,316
14,NOTA,None of the Above,7641,16,7657,0.67,SAGAR,Madhya Pradesh,317
1,GANESH SINGH,Bharatiya Janata Party,458373,1355,459728,43.41,SATNA,Madhya Pradesh,318
2,DABBU SIDDHARTH SUKHLAL KUSHWAHA,Indian National Congress,373982,797,374779,35.39,SATNA,Madhya Pradesh,319
3,NARAYAN TRIPATHI,Bahujan Samaj Party,185303,315,185618,17.53,SATNA,Madhya Pradesh,320
4,DURGESH KUMAR VISHWAKARMA,Independent,5919,2,5921,0.56,SATNA,Madhya Pradesh,321
5,RAHUL DAHIYA,Independent,4276,1,4277,0.4,SATNA,Madhya Pradesh,322
6,CHHEDI LAL PRAJAPATI (PANDA  BABA),Independent,4060,1,4061,0.38,SATNA,Madhya Pradesh,323
7,CHANDRABHAN KOL,Independent,3393,5,3398,0.32,SATNA,Madhya Pradesh,324
8,"SAFI ULLA ""DBBU BHAI""",Independent,2612,2,2614,0.25,SATNA,Madhya Pradesh,325
9,ADV. ASHOK SAKET,Bahujan Dravida Party,2396,3,2399,0.23,SATNA,Madhya Pradesh,326
10,AZEEZ AHMED QURAISHY,Manviya Bharat Party,2078,4,2082,0.2,SATNA,Madhya Pradesh,327
11,MASTER JI AJIT KUMAR JAYSWAL,Peoples Party of India (Democratic),1887,4,1891,0.18,SATNA,Madhya Pradesh,328
12,KALIM AHMAD BACHCHA,Independent,1622,8,1630,0.15,SATNA,Madhya Pradesh,329
13,SUKHLAL VERMA RATNESH,Independent,1616,1,1617,0.15,SATNA,Madhya Pradesh,330
14,ASHOK KUMAR GUPTA,Bhartiya Shakti Chetna Party,1259,6,1265,0.12,SATNA,Madhya Pradesh,331
15,NANKU YADAV,Akhil Bharatiya Hind Kranti Party,1254,5,1259,0.12,SATNA,Madhya Pradesh,332
16,RISHABH SINGH,Independent,1068,5,1073,0.1,SATNA,Madhya Pradesh,333
17,ASHOK BAUDH,Independent,945,2,947,0.09,SATNA,Madhya Pradesh,334
18,HARI SHANKAR TIWARI (LOHA WALA),Bharatiya Jan Morcha Party,935,10,945,0.09,SATNA,Madhya Pradesh,335
19,RANJANA MISHRA,Nyaydharmsabha,905,10,915,0.09,SATNA,Madhya Pradesh,336
20,NOTA,None of the Above,2538,15,2553,0.24,SATNA,Madhya Pradesh,337
1,SMT. HIMADRI SINGH,Bharatiya Janata Party,709477,1666,711143,61.73,SHAHDOL,Madhya Pradesh,338
2,PHUNDE LAL SINGH MARKO,Indian National Congress,312833,970,313803,27.24,SHAHDOL,Madhya Pradesh,339
3,ANIL SINGH DHURVEY,Gondvana Gantantra Party,35186,92,35278,3.06,SHAHDOL,Madhya Pradesh,340
4,DHANI RAM KOL,Bahujan Samaj Party,21792,62,21854,1.9,SHAHDOL,Madhya Pradesh,341
5,SAMAR SHAH SINGH GOND,Communist Party of India,19861,22,19883,1.73,SHAHDOL,Madhya Pradesh,342
6,KESHKALI BAIGA,Independent,10042,29,10071,0.87,SHAHDOL,Madhya Pradesh,343
7,GUNJAN SINGH,Independent,7460,19,7479,0.65,SHAHDOL,Madhya Pradesh,344
8,RAVIKARAN SINGH DHURVE,Bhartiya Shakti Chetna Party,4964,11,4975,0.43,SHAHDOL,Madhya Pradesh,345
9,AMRIT LAL SINGH UIKEY,Peoples Party of India (Democratic),4701,21,4722,0.41,SHAHDOL,Madhya Pradesh,346
10,DR. DURGA WATI BHARIA,Chhattisgarh Vikas Ganga Rashtriya Party,3425,19,3444,0.3,SHAHDOL,Madhya Pradesh,347
11,NOTA,None of the Above,19341,20,19361,1.68,SHAHDOL,Madhya Pradesh,348
1,DR. RAJESH MISHRA,Bharatiya Janata Party,582664,895,583559,50.87,SIDHI,Madhya Pradesh,349
2,KAMLESHWAR INDRAJIT KUMAR,Indian National Congress,376336,807,377143,32.87,SIDHI,Madhya Pradesh,350
3,AJAY PRATAP SINGH,Gondvana Gantantra Party,50897,65,50962,4.44,SIDHI,Madhya Pradesh,351
4,PUJAN RAM SAKET (BABBU),Bahujan Samaj Party,33617,39,33656,2.93,SIDHI,Madhya Pradesh,352
5,LAXMAN SINGH BAIS,Independent,30634,28,30662,2.67,SIDHI,Madhya Pradesh,353
6,SANJAY NAMDEO,Communist Party of India,20284,6,20290,1.77,SIDHI,Madhya Pradesh,354
7,BHAGWAN PRASAD TIWARI,Independent,7330,1,7331,0.64,SIDHI,Madhya Pradesh,355
8,SUNIL TIWARI,Independent,5694,5,5699,0.5,SIDHI,Madhya Pradesh,356
9,SHYAMLAL VAISH,Bhartiya Shakti Chetna Party,5340,3,5343,0.47,SIDHI,Madhya Pradesh,357
10,KAILASH PRASAD VERMA,Independent,5289,2,5291,0.46,SIDHI,Madhya Pradesh,358
11,MAHENDRA BHAIYA,Independent,4658,-,4658,0.41,SIDHI,Madhya Pradesh,359
12,DASHRATH PRASAD BAIS,Independent,4131,-,4131,0.36,SIDHI,Madhya Pradesh,360
13,"NARAYAN DAS SHAH ""MULNIWASI""",Peoples Party of India (Democratic),3791,1,3792,0.33,SIDHI,Madhya Pradesh,361
14,DADDI YADAV,Independent,3301,4,3305,0.29,SIDHI,Madhya Pradesh,362
15,SMT. TARA DEVI SINGH,Rashtriya Jansanchar Dal,2701,6,2707,0.24,SIDHI,Madhya Pradesh,363
16,RAMSAHAY SAHU,Aapka Gantantra Party,2430,2,2432,0.21,SIDHI,Madhya Pradesh,364
17,RAMVISHAL KOL,Rashtriya Samaj Paksha,2079,8,2087,0.18,SIDHI,Madhya Pradesh,365
18,NOTA,None of the Above,4212,4,4216,0.37,SIDHI,Madhya Pradesh,366
1,DR. VIRENDRA KUMAR,Bharatiya Janata Party,713781,1269,715050,65.1,TIKAMGARH,Madhya Pradesh,367
2,KHUMAN URF PANKAJ AHIRWAR,Indian National Congress,311134,604,311738,28.38,TIKAMGARH,Madhya Pradesh,368
3,AHIRWAR DALLURAM,Bahujan Samaj Party,32604,69,32673,2.97,TIKAMGARH,Madhya Pradesh,369
4,AHIRWAR PANKAJ,Rashtriya Samaj Paksha,10147,11,10158,0.92,TIKAMGARH,Madhya Pradesh,370
5,SARJU PRASAD,Independent,5993,4,5997,0.55,TIKAMGARH,Madhya Pradesh,371
6,N.R. PRAJAPATI,Adarsh Nyay Rakshak Party,5475,9,5484,0.5,TIKAMGARH,Madhya Pradesh,372
7,BABULAL KHANGAR,Independent,4452,7,4459,0.41,TIKAMGARH,Madhya Pradesh,373
8,NOTA,None of the Above,12816,15,12831,1.17,TIKAMGARH,Madhya Pradesh,374
1,ANIL FIROJIYA,Bharatiya Janata Party,834374,1730,836104,62.93,UJJAIN,Madhya Pradesh,375
2,MAHESH PARMAR,Indian National Congress,459531,713,460244,34.64,UJJAIN,Madhya Pradesh,376
3,ADVOCATE PRAKASH CHOUHAN,Bahujan Samaj Party,9502,16,9518,0.72,UJJAIN,Madhya Pradesh,377
4,DR. HEMANT PARMAR,Bhim Sena,4973,3,4976,0.37,UJJAIN,Madhya Pradesh,378
5,SURESH BAGARI,Independent,2786,5,2791,0.21,UJJAIN,Madhya Pradesh,379
6,MAHESH PARMAR,Independent,2468,8,2476,0.19,UJJAIN,Madhya Pradesh,380
7,GANGA MALVIYA,Independent,1288,7,1295,0.1,UJJAIN,Madhya Pradesh,381
8,ANIL,Independent,979,2,981,0.07,UJJAIN,Madhya Pradesh,382
9,ISHWARLAL VARSHI,Independent,860,3,863,0.06,UJJAIN,Madhya Pradesh,383
10,NOTA,None of the Above,9310,22,9332,0.7,UJJAIN,Madhya Pradesh,384
1,SHIVRAJ SINGH CHOUHAN,Bharatiya Janata Party,1111556,4904,1116460,76.7,VIDISHA,Madhya Pradesh,385
2,PRATAPBHANU SHARMA,Indian National Congress,293537,1515,295052,20.27,VIDISHA,Madhya Pradesh,386
3,KISHAN LAL LADIYA,Bahujan Samaj Party,10734,82,10816,0.74,VIDISHA,Madhya Pradesh,387
4,KAMLESH KUMAR GOUR,Jai Prakash Janata Dal,8167,11,8178,0.56,VIDISHA,Madhya Pradesh,388
5,DHOOLSINGH DHAMMA,Independent,3417,7,3424,0.24,VIDISHA,Madhya Pradesh,389
6,SATYENDRA SINGH SISODIYA,Independent,2921,4,2925,0.2,VIDISHA,Madhya Pradesh,390
7,DHARMVIR BHARTI,Akhil Bhartiya Parivar Party,2809,10,2819,0.19,VIDISHA,Madhya Pradesh,391
8,ABDUL RASHID,Independent,1679,3,1682,0.12,VIDISHA,Madhya Pradesh,392
9,BHAI MUNSHILAL SILAWAT,Public Political Party,1114,3,1117,0.08,VIDISHA,Madhya Pradesh,393
10,ABDUL JABBAR,Independent,1076,6,1082,0.07,VIDISHA,Madhya Pradesh,394
11,SEEMA SHARMA,Sapaks Party,1065,8,1073,0.07,VIDISHA,Madhya Pradesh,395
12,DHARMENDRA SINGH PANWAR (GOLU BHAIYA),Right to Recall Party,1025,1,1026,0.07,VIDISHA,Madhya Pradesh,396
13,BHEEKAM SINGH KUSHWAHA,Mahanwadi Party,720,4,724,0.05,VIDISHA,Madhya Pradesh,397
14,NOTA,None of the Above,9218,62,9280,0.64,VIDISHA,Madhya Pradesh,398
